NO ./textures/wood.png
SO ./textures/wood.png
WE ./textures/wood.png
EA ./textures/wood.png

F 220,100,0
C 225,30,0

        1111111111111111111111111
        1000000000110000000000001
        1011000001110000000000001
        1001000000000000000000001
111111111011000001110000000000001
100000000011000001110111111111111
11111111111111011100000010001
10101111111111011101010010001
10010000110101011100000010001
101W1000000000001100000010001
10010000000000001101010010001
11000001110101011111011110011
11110111 1110101 101111010001
11111111 1111111 111111111111
